00000000000000000000000000
00000000000000000000000000
00110011001100000011001100
00110011001100000011001100
00110011001100000011001100
00110011001100000011001100
00110011001100000011001100
00110011001100000011001100
00110011000000000011001100
00110011000000000011001100
00000000001100001100000000
00000000001100001100000000
11001111000000000011110011
22001111000000000011110022
00000000001100110000000000
00000000001111110000000000
00110011001111110110011000
00110011001100110110011000
00110011001100110110011000
00110011001100110110011000
00110011001100110110011000
00110011000000000110011000
00110011000000000110011000
00110011000111100110011000
00000000000100100000000000
00000000000100100000000000